W W W W W W W W W W W W W W W W
W E E E E E E E E E E E E E E W
W E E E E E E E E E E E E E E W
W E E E L E E E E E E L E E E W
W E E E E E E E E E E E E E E W
W E E E E E E E E E E E E E E W
W E E E E E E E S E E E E E E W
W E E E E E E E E E E E E E E W
W E E E E E E E E E E E E E E W
W E E E L E E E E E E L E E E W
W E E E E E E E E E E E E E E W
W E E E E E E E E E E E E E E W
W W W W W W W W W W W W W W W W