W W W W W W W W W W W W W W W W
W E E E E E E E E E E E E E E W
W E E E E E E E E E E E E E E W
W E E E L W E E E E E L W E E W
W E E E E W E E E E E W W E E W
W E E E E W E E E E E W E E E W
W E E E E W E E S E E W E E E W
W E E E E W E E E E E W E E E W
W E E E E W E E E E W W E E E W
W E E E L W W W W W W L E E E W
W E E E E E E E E E E E E E E W
W E E E E E E E E E E E E E E W
W W W W W W W W W W W W W W W W